#### ###
#      #
# ### ##
# #    #
# # #### 
# ###  #
#      #
###### #
