## ########
#   #   # #
# ### ### #
#     # # #
##### # # #
# # #   # #
# # ###   #
#   #   ###
### # ### #
#         #
# #########
